MAZE: "mylevel", ' '
FLAGS:hardfloor
INIT_MAP: solidfill,' '
GEOMETRY:center,center
MAP
..........
..........
..........
..........
..........
..........
..........
..........
..........
..........
ENDMAP
REGION:(0,0,9,9),lit,"ordinary"
$all_map = selection:fillrect (0,0,9,9)

OBJECT:('%',"apple"),rndcoord($all_map),uncursed
OBJECT:('[',"leather cloak"),rndcoord($all_map),uncursed