MAZE: "mylevel",' '
INIT_MAP:solidfill,' '
GEOMETRY:center,center
MAP
-------------
|.+.........|
|--.........|
|...........|
|...........|
|...........|
-------------
ENDMAP
REGION:(0,0,12,6),lit,"ordinary"
$all_map = selection:fillrect (1,1,11,5)

DOOR:closed,(2,1)
# OBJECT:('(', "towel"),(1,1),uncursed
OBJECT:('!',"blindness"),(1,1),uncursed
BRANCH:(1,1,1,1),(0,0,0,0)
STAIR:rndcoord(filter('.',$all_map)),down